...D..DV..
.....DD.DV
V.D.DD..D.
...DD..D..
.DV..VD.V.
V.......D.
...V.D....
...DVD..DV
...D.V..D.
DV....D...