D........D.....D........D.....
V..V.....V..D..V..V.....V..D..
.D....V.........D....V........
........D..............D......
...D..............D...........
..........D..............D....
...V..V.....D.....V..V.....D..
..............................
.....D...D..........D...D.....
...V...D..........V...D.......
..........V..............V....
.....D.V............D.V.......
..........D..............D....
...D..............D...........
.......D..............D.......
D........D.....D........D.....
V..V.....V..D..V..V.....V..D..
.D....V.........D....V........
........D..............D......
...D..............D...........
..........D..............D....
...V..V.....D.....V..V.....D..
..............................
.....D...D..........D...D.....
...V...D..........V...D.......
..........V..............V....
.....D.V............D.V.......
..........D..............D....
...D..............D...........
.......D..............D.......